CCCCWWWCWCCWWWW
WWWCCCWCCCWWWWC
CCCWWCCCWSCCCCC
CWCCCCCWWWCWCCW
CCWWCWWWWWCCCCC
WCWWCWWCCWCWWWW
WCCWWWWWCCCCWWW
WWCWWWWWCWWCWCW
CWWWWWCWwCCWWWW
CCCWWWCCCCCCCWW
CWCCWWWWCWWWCCC
CWCWWWCCCXCWWCW
WWWCCCCCCCCCCCC
WWWCWWWCWWWWWWC
CCCCWWWCCCCWWCC