WWWWWWWWWWWWWWW
WCSCCCWCCCWWWWW
WCCWWCCCWWCCCCW
WWCCCCCWWWCWCCW
WCCWCWWWWWCCCCW
WCWWCWWCCWCWWWW
WCCWWWWWCCCCWWW
WWXWWWWWCWWCWCW
WWCWWWCWCCCWWWW
WCCWWWCCCCCCCWW
WWCCWWWWCWWWCCW
WWCWWWCCCCCWWCW
WWWCCCCCCCCCCCW
WWWCWWWCWWWWWWW
WWWWWWWWWWWWWWW
