CSCCWWWCWCCWWWW
WWWCCCWCCCWWWWC
CCCWWCCCWWCCCCC
CWWWWWCWwCCWWWW
CCCWWWCCCCCCCWW
CWCCWWWWCWWWCCC
CWCWWWCCCCCWWCW
CWCCCCCWWWCWCCW
CCWWCWWWWWCCCCC
WCWWCWWCCWCWWWW
WCCWWWWWCCCCWWW
WWXWWWWWCWWCWCW
WWWCCCCCCCCCCCC
WWWCWWWCWWWWWWC
CCCCWWWCCCCWWCC
